TPC Members
Cristina Alcaraz	University of Malaga
Rizwan Asghar	University of Auckland
Man Ho Au	Hong Kong Polytechnic University
Joonsang Baek	University of Wollongong
Shi Bai	Florida Atlantic University
Zubair Baig	Deakin University
Lynn Batten	Deakin University
Elisa Bertino	Purdue University
L. Jean Camp	Indiana University
Aniello Castiglione	University of Salerno
Rongmao Chen	National University of Defense Technology
Shiping Chen	CSIRO
Xiaofeng Chen	Xidian University
Jinjun Chen	Swinburne University of Technology
Liqun Chen	University of Surrey
Naccache David	Ecole Normale Superieure
Josep Domingo-Ferrer	Universitat Rovira i Virgili
Ernest Foo	Queensland University of Technology
Gerhard Hancke	City University of Hong Kong
Xinyi Huang	Fujian Normal University
Qiong Huang	South China Agricultural University
Tibor Jager	Ruhr University Bochum
Peng Jiang	Beijing Institute of Technology
Jongkil Kim	University of Wollongong
Huy Kang Kim	Korea University
Ryan Ko	University of Waikato
Noboru Kunihiro	University of Tokyo
Fabien Laguillaumie	Université de Lyon 1 / LIP
Jianchang Lai	University of Wollongong
Joseph Liu	Monash University
Dongxi Liu	CSIRO
Javier Lopez	University of Malaga
Mark Manulis	University of Surrey
Mitsuru Matsui	Mitsubishi Electric
Kazuhiko Minematsu	NEC Corporation
Chris Mitchell	Royal Holloway, University of London
Kirill Morozov	University of North Texas
Yi Mu	Fujian Normal University
Khoa Nguyen	Nanyang Technological University
Thomas Peyrin	Nanyang Technological University
Duong Hieu Phan	XLIM (Limoges University)
Josef Pieprzyk	Queensland University of Technology
Chun Ruan	Western Sydney University
Pierangela Samarati	Politecnico di Milano
Marcos Simplicio	University of São Paulo, Brazil
Leonie Simpson	Queensland University of Technology
Ron Steinfeld	Monash University
Willy Susilo	University of Wollongong
Atsushi Takayasu	The University of Tokyo
Qiang Tang	Cornell University
Clark Thomborson	University of Auckland
Damien Vergnaud	Ecole Normale Superieure
Ding Wang	Peking University
Huaxiong Wang	Nanyang Technological University
Paul Watters	La Trobe University
Guomin Yang	University of Wollongong
Ji Won Yoon	Korea University
Yong Yu	Shaanxi Normal University, China
Mingwu Zhang	Hubei University of Technology