Program Chairs	Lujo Bauer	CyLab, Carnegie Mellon University, USA
Frank Stajano	University of Cambrige, UK
PC Members	AbdelRahman Abdou	Carleton University
Alexandra Dmitrienko	University of Würzburg
Andrei Sabelfeld	Chalmers
Benjamin Dowling	ETH Zurich
Brendan Saltaformaggio	Georgia Tech
Carmela Troncoso	EPFL
Catherine Meadows	Naval Research Lab
Christoph Dobraunig	Radboud University
Corina Pasareanu	NASA / CMU SV
Cristina Onete	U Limoges
David Chisnall	Microsoft Research Cambridge
Elizabeth Stobert	Carleton University
Frank Stajano	University of Cambridge
Gang Tan	Pennsylvania State University
Giancarlo Pellegrino	CISPA
Ioana Boureanu	Surrey
Ivan Martinovic	University of Oxford
Jelena Mirkovic	USC/Information Sciences Institute
Joseph Bonneau	NYU
Kami Vaniea	University of Edinburgh
Katharina Krombholz	CISPA
Kevin Butler	University of Florida
Konrad Rieck	TU Braunschweig
Laurent Simon	Google
Lejla Batina	Radboud University
Limin Jia	CMU
Lujo Bauer	Carnegie Mellon University
Marco Guarnieri	IMDEA Software Institute
Martin Johns	TU Braunschweig
Mathy Vanhoef	New York University Abu Dhabi
Matthew Green	Johns Hopkins
Matthew Smith	University of Bonn, Fraunhofer FKIE
Musard Balliu	KTH Royal Institute of Technology
Nick Nikiforakis	Stony Brook University
Nicolas Christin	CMU
Ralf Sasse	ETH Zurich
Sadia Afroz	ICSI
Sang Kil Cha	KAIST
Sarah Meiklejohn	University College London
Simson Garfinkel	US Census Bureau
Stefano Calzavara	Università Ca' Foscari Venezia
Steve Kremer	INRIA Nancy - Grand Est
Suman Jana	Columbia University
Tom Chotia	University of Birmingham
Ulrike Meyer	RWTH Aachen University
Vanessa Teague	University of Melbourne
Vera Rimmer	KU Leuven
Yajin Zhou	Zhejiang University
Yeoul Na	UC Irvine
Yongdae Kim	KAIST
Yuan Tian	U Virginia
Zhenkai Liang	National University of Singapore
Zinaida Benenson	University of Erlangen-Nuremberg
